##########
#@.......#
#........#
#........#
#........#
#........#
#........#
#........#
#.......*#
##########